%%%%%%%%%%%%%%%%%%%%%%%%%%%%%%%%%%%%%
%                                  S%
%            %                      %
%            %                      %
%            %                      %
%            %                      %
%            %                      %
%            %      %               %
%            %      %               %
%            %      %               %
%            %      %               %
%            %      %               %
%            %      %               %
%            %      %               %
%%%%%%%%%%%%%%      %%%%%%%%%%%%%%%%%
%            %                      %
%            %                      %
%            %                      %
%                                   %
%                                   %
%                                   %
%G                                  %
%%%%%%%%%%%%%%%%%%%%%%%%%%%%%%%%%%%%%
